name,Simple_Small_ir,Simple_Large_ir,Simple_Large_diff,Simple_Large_pct,Complex_Medium_ir,Complex_Medium_diff,Complex_Medium_pct,Complex_Large_ir,Complex_Large_diff,Complex_Large_pct
(below main),40,28,-12,-30.000,40,0,0.000,40,0,0.000
0x0000000000001070,5,0,-5,-100.000,5,0,0.000,0,-5,-100.000
0x00000000000010e0,26,0,-26,-100.000,26,0,0.000,26,0,0.000
0x0000000000001170,12,0,-12,-100.000,12,0,0.000,12,0,0.000
0x0000000000001260,5,0,-5,-100.000,0,-5,-100.000,0,-5,-100.000
0x00000000000012d0,13,0,-13,-100.000,0,-13,-100.000,0,-13,-100.000
0x00000000000012f0,5,0,-5,-100.000,5,0,0.000,0,-5,-100.000
0x0000000000001310,12,0,-12,-100.000,5,-7,-58.333,0,-12,-100.000
0x0000000000001380,0,0,0,0.000,13,13,100.000,13,13,100.000
0x00000000000013c0,0,0,0,0.000,12,12,100.000,12,12,100.000
0x000000000000e3b0,0,0,0,0.000,5,5,100.000,0,0,0.000
0x000000000000e420,0,0,0,0.000,13,13,100.000,13,13,100.000
0x000000000000e460,0,0,0,0.000,12,12,100.000,12,12,100.000
0x0000000000020290,19,0,-19,-100.000,19,0,0.000,19,0,0.000
0x0000000000109000,7,0,-7,-100.000,7,0,0.000,0,-7,-100.000
0x00000000001090b0,200,200,0,0.000,0,-200,-100.000,0,-200,-100.000
0x00000000001090c0,202,202,0,0.000,2000,1798,890.099,10000,9798,4850.495
0x00000000001090d0,200,200,0,0.000,0,-200,-100.000,0,-200,-100.000
0x0000000000109100,202,202,0,0.000,0,-202,-100.000,0,-202,-100.000
0x0000000000109110,0,0,0,0.000,8,8,100.000,0,0,0.000
0x0000000000109130,0,0,0,0.000,2000,2000,100.000,10000,10000,100.000
0x00000000001097f8,0,0,0,0.000,4,4,100.000,0,0,0.000
0x0000000004002050,6,0,-6,-100.000,12,6,100.000,12,6,100.000
0x000000000483f000,9,0,-9,-100.000,9,0,0.000,0,-9,-100.000
0x000000000483f334,5,0,-5,-100.000,5,0,0.000,0,-5,-100.000
0x0000000004865000,0,0,0,0.000,7,7,100.000,0,0,0.000
0x000000000487f3e0,10,0,-10,-100.000,0,-10,-100.000,0,-10,-100.000
0x000000000487f4d0,408,408,0,0.000,0,-408,-100.000,0,-408,-100.000
0x000000000487f650,43,43,0,0.000,0,-43,-100.000,0,-43,-100.000
0x000000000487f6d0,7,0,-7,-100.000,0,-7,-100.000,0,-7,-100.000
0x00000000048e08c8,0,0,0,0.000,4,4,100.000,0,0,0.000
0x00000000049663e0,0,0,0,0.000,30,30,100.000,30,30,100.000
0x0000000004966490,0,0,0,0.000,10,10,100.000,10,10,100.000
0x00000000049664d0,0,0,0,0.000,4020,4020,100.000,20020,20020,100.000
0x0000000004966620,0,0,0,0.000,8,8,100.000,0,0,0.000
0x0000000004966650,0,0,0,0.000,43,43,100.000,43,43,100.000
0x00000000049666d0,0,0,0,0.000,7,7,100.000,0,0,0.000
_Exit,5,0,-5,-100.000,5,0,0.000,0,-5,-100.000
_IO_cleanup,138,130,-8,-5.797,138,0,0.000,130,-8,-5.797
_IO_default_setbuf,51,44,-7,-13.725,51,0,0.000,44,-7,-13.725
_IO_default_xsputn,24024,24024,0,0.000,228074,204050,849.359,916074,892050,3713.162
_IO_do_write@@GLIBC_2.2.5,69,61,-8,-11.594,69,0,0.000,61,-8,-11.594
_IO_doallocbuf,26,0,-26,-100.000,26,0,0.000,19,-7,-26.923
_IO_file_doallocate,69,56,-13,-18.841,69,0,0.000,56,-13,-18.841
_IO_file_overflow@@GLIBC_2.2.5,74,74,0,0.000,74,0,0.000,74,0,0.000
_IO_file_setbuf@@GLIBC_2.2.5,14,0,-14,-100.000,14,0,0.000,14,0,0.000
_IO_file_sync@@GLIBC_2.2.5,18,0,-18,-100.000,18,0,0.000,18,0,0.000
_IO_file_write@@GLIBC_2.2.5,37,37,0,0.000,37,0,0.000,37,0,0.000
_IO_file_xsputn@@GLIBC_2.2.5,296,289,-7,-2.365,618,322,108.784,611,315,106.419
_IO_flush_all_lockp,118,110,-8,-6.780,118,0,0.000,110,-8,-6.780
_IO_no_init,2300,2300,0,0.000,23000,20700,900.000,115000,112700,4900.000
_IO_old_init,2300,2300,0,0.000,23000,20700,900.000,115000,112700,4900.000
_IO_padn,0,0,0,0.000,51000,51000,100.000,51000,51000,100.000
_IO_setb,2424,2424,0,0.000,24024,21600,891.089,120024,117600,4851.485
_IO_str_init_static_internal,4800,4800,0,0.000,48000,43200,900.000,240000,235200,4900.000
__GI___close_nocancel,18,0,-18,-100.000,24,6,33.333,24,6,33.333
__GI___tunable_set_val,290,280,-10,-3.448,290,0,0.000,290,0,0.000
__GI___tunables_init,20786,20786,0,0.000,20786,0,0.000,20786,0,0.000
____strtol_l_internal,139,158,19,13.669,158,19,13.669,158,19,13.669
__acos_finite@GLIBC_2.15,0,0,0,0.000,7,7,100.000,0,0,0.000
__asin_finite@GLIBC_2.15,0,0,0,0.000,6,6,100.000,0,0,0.000
__atan2_finite@GLIBC_2.15,0,0,0,0.000,7,7,100.000,0,0,0.000
__call_tls_dtors,12,0,-12,-100.000,12,0,0.000,12,0,0.000
__ctype_init,17,0,-17,-100.000,17,0,0.000,17,0,0.000
__cxa_atexit,39,39,0,0.000,39,0,0.000,39,0,0.000
__cxa_finalize,112,112,0,0.000,168,56,50.000,168,56,50.000
__exp_finite@GLIBC_2.15,0,0,0,0.000,7,7,100.000,0,0,0.000
__glibc_morecore,18,0,-18,-100.000,18,0,0.000,18,0,0.000
__init_misc,25,0,-25,-100.000,25,0,0.000,25,0,0.000
__libc_alloca_cutoff,0,0,0,0.000,33,33,100.000,33,33,100.000
__libc_cleanup_pop_restore,32,32,0,0.000,48,16,50.000,48,16,50.000
__libc_cleanup_push_defer,40,40,0,0.000,60,20,50.000,60,20,50.000
__libc_early_init,50,0,-50,-100.000,50,0,0.000,42,-8,-16.000
__libc_scratch_buffer_set_array_size,40,40,0,0.000,60,20,50.000,60,20,50.000
__libc_start_main@@GLIBC_2.34,71,71,0,0.000,71,0,0.000,71,0,0.000
__lll_elision_init,37,37,0,0.000,37,0,0.000,37,0,0.000
__log_finite@GLIBC_2.15,0,0,0,0.000,7,7,100.000,0,0,0.000
__memcpy_avx_unaligned_erms,0,0,0,0.000,44,44,100.000,44,44,100.000
__mempcpy_avx_unaligned_erms,85,82,-3,-3.529,257,172,202.353,257,172,202.353
__minimal_calloc,88,80,-8,-9.091,110,22,25.000,110,22,25.000
__minimal_free,15,0,-15,-100.000,20,5,33.333,20,5,33.333
__minimal_malloc,645,645,0,0.000,770,125,19.380,770,125,19.380
__mpn_cmp,0,0,0,0.000,48,48,100.000,48,48,100.000
__mpn_divrem,0,0,0,0.000,552,552,100.000,552,552,100.000
__mpn_extract_double,0,0,0,0.000,66,66,100.000,66,66,100.000
__mpn_lshift,0,0,0,0.000,48,48,100.000,48,48,100.000
__mpn_mul,0,0,0,0.000,84,84,100.000,126,126,100.000
__mpn_mul_1,0,0,0,0.000,402,402,100.000,393,393,100.000
__mpn_rshift,0,0,0,0.000,72,72,100.000,90,90,100.000
__new_exitfn,32,32,0,0.000,32,0,0.000,32,0,0.000
__open_nocancel,277,277,0,0.000,318,41,14.801,318,41,14.801
__pow_finite@GLIBC_2.15,0,0,0,0.000,6,6,100.000,0,0,0.000
__pread64_nocancel,28,0,-28,-100.000,28,0,0.000,28,0,0.000
__printf_chk,60,60,0,0.000,144,84,140.000,144,84,140.000
__printf_fp,0,0,0,0.000,21,21,100.000,21,21,100.000
__printf_fp_l,0,0,0,0.000,2307,2307,100.000,2483,2483,100.000
__pthread_tunables_init,21,0,-21,-100.000,21,0,0.000,21,0,0.000
__read_nocancel,12,0,-12,-100.000,18,6,50.000,18,6,50.000
__rtld_malloc_init_real,108,108,0,0.000,108,0,0.000,108,0,0.000
__rtld_malloc_init_stubs,10,0,-10,-100.000,10,0,0.000,10,0,0.000
__rtld_mutex_init,42,42,0,0.000,42,0,0.000,42,0,0.000
__run_exit_handlers,79,79,0,0.000,79,0,0.000,79,0,0.000
__sigjmp_save,9,0,-9,-100.000,9,0,0.000,9,0,0.000
__sigsetjmp,94,94,0,0.000,166,72,76.596,166,72,76.596
__snprintf_chk,3100,3100,0,0.000,31000,27900,900.000,155000,151900,4900.000
__strchrnul_avx2,3876,3876,0,0.000,38190,34314,885.294,190190,186314,4806.863
__strlen_avx2,1414,1414,0,0.000,70,-1344,-95.050,70,-1344,-95.050
__strrchr_avx2,28,0,-28,-100.000,28,0,0.000,28,0,0.000
__tls_init_tp,55,36,-19,-34.545,55,0,0.000,49,-6,-10.909
__tls_pre_init_tp,17,0,-17,-100.000,17,0,0.000,17,0,0.000
__tunable_get_val,677,677,0,0.000,698,21,3.102,698,21,3.102
__unregister_atfork,30,30,0,0.000,45,15,50.000,45,15,50.000
__vfprintf_internal,31098,31098,0,0.000,372522,341424,1097.897,1784522,1753424,5638.382
__vsnprintf_internal,5700,5700,0,0.000,57000,51300,900.000,285000,279300,4900.000
__x86_cacheinfo,25,0,-25,-100.000,25,0,0.000,25,0,0.000
__x86_cpu_features,6,0,-6,-100.000,6,0,0.000,0,-6,-100.000
_dl_add_to_namespace_list,112,112,0,0.000,159,47,41.964,159,47,41.964
_dl_add_to_slotinfo,28,0,-28,-100.000,28,0,0.000,28,0,0.000
_dl_allocate_tls_init,102,102,0,0.000,102,0,0.000,102,0,0.000
_dl_allocate_tls_storage,350,350,0,0.000,353,3,0.857,350,0,0.000
_dl_assign_tls_modid,10,0,-10,-100.000,10,0,0.000,10,0,0.000
_dl_audit_activity_map,16,0,-16,-100.000,16,0,0.000,16,0,0.000
_dl_audit_activity_nsid,63,63,0,0.000,63,0,0.000,63,0,0.000
_dl_audit_objclose,20,0,-20,-100.000,25,5,25.000,25,5,25.000
_dl_audit_objopen,10,0,-10,-100.000,15,5,50.000,15,5,50.000
_dl_audit_preinit,5,0,-5,-100.000,5,0,0.000,0,-5,-100.000
_dl_cache_libcmp,802,802,0,0.000,1604,802,100.000,1604,802,100.000
_dl_call_libc_early_init,24,0,-24,-100.000,24,0,0.000,24,0,0.000
_dl_catch_error,23,0,-23,-100.000,23,0,0.000,23,0,0.000
_dl_catch_exception,105,105,0,0.000,210,105,100.000,210,105,100.000
_dl_cet_check,30,30,0,0.000,30,0,0.000,30,0,0.000
_dl_check_all_versions,72,72,0,0.000,85,13,18.056,85,13,18.056
_dl_check_map_versions,2449,2440,-9,-0.367,3884,1435,58.595,3884,1435,58.595
_dl_count_modids,6,0,-6,-100.000,6,0,0.000,0,-6,-100.000
_dl_debug_initialize,30,30,0,0.000,30,0,0.000,30,0,0.000
_dl_debug_state,0,0,0,0.000,4,4,100.000,0,0,0.000
_dl_debug_update,21,0,-21,-100.000,28,7,33.333,28,7,33.333
_dl_determine_tlsoffset,76,76,0,0.000,76,0,0.000,76,0,0.000
_dl_discover_osversion,84,84,0,0.000,84,0,0.000,84,0,0.000
_dl_dst_count,36,36,0,0.000,90,54,150.000,90,54,150.000
_dl_find_object_from_map,257,257,0,0.000,315,58,22.568,315,58,22.568
_dl_find_object_init,37,37,0,0.000,37,0,0.000,37,0,0.000
_dl_fini,252,252,0,0.000,306,54,21.429,306,54,21.429
_dl_fixup,188,188,0,0.000,188,0,0.000,188,0,0.000
_dl_hwcaps_contains,30,30,0,0.000,30,0,0.000,30,0,0.000
_dl_hwcaps_split,12,0,-12,-100.000,12,0,0.000,12,0,0.000
_dl_hwcaps_split_masked,437,437,0,0.000,437,0,0.000,437,0,0.000
_dl_hwcaps_subdirs_active,47,40,-7,-14.894,47,0,0.000,40,-7,-14.894
_dl_important_hwcaps,812,812,0,0.000,815,3,0.369,812,0,0.000
_dl_init,101,101,0,0.000,116,15,14.851,116,15,14.851
_dl_init_paths,317,312,-5,-1.577,317,0,0.000,312,-5,-1.577
_dl_load_cache_lookup,368,348,-20,-5.435,704,336,91.304,704,336,91.304
_dl_lookup_direct,268,268,0,0.000,268,0,0.000,268,0,0.000
_dl_lookup_symbol_x,20965,20965,0,0.000,23170,2205,10.518,23170,2205,10.518
_dl_map_object,458,458,0,0.000,954,496,108.297,954,496,108.297
_dl_map_object_deps,967,948,-19,-1.965,1409,442,45.708,1401,434,44.881
_dl_map_object_from_fd,2650,2650,0,0.000,4037,1387,52.340,4037,1387,52.340
_dl_name_match_p,387,387,0,0.000,1054,667,172.351,1054,667,172.351
_dl_new_object,603,585,-18,-2.985,778,175,29.022,778,175,29.022
_dl_next_ld_env_entry,283,283,0,0.000,283,0,0.000,283,0,0.000
_dl_process_pt_gnu_property,60,60,0,0.000,80,20,33.333,80,20,33.333
_dl_receive_error,17,0,-17,-100.000,17,0,0.000,17,0,0.000
_dl_relocate_object,28747,28747,0,0.000,30695,1948,6.776,30695,1948,6.776
_dl_runtime_resolve_xsave,82,82,0,0.000,82,0,0.000,82,0,0.000
_dl_setup_hash,116,116,0,0.000,145,29,25.000,145,29,25.000
_dl_sort_maps,254,254,0,0.000,286,32,12.598,286,32,12.598
_dl_sort_maps_init,12,0,-12,-100.000,12,0,0.000,12,0,0.000
_dl_start,2051,2051,0,0.000,2051,0,0.000,2051,0,0.000
_dl_sysdep_read_whole_file,42,42,0,0.000,42,0,0.000,42,0,0.000
_dl_sysdep_start,464,464,0,0.000,464,0,0.000,464,0,0.000
_dl_tls_static_surplus_init,37,37,0,0.000,37,0,0.000,37,0,0.000
_dl_unload_cache,12,0,-12,-100.000,12,0,0.000,12,0,0.000
_dl_x86_init_cpu_features,5,0,-5,-100.000,5,0,0.000,0,-5,-100.000
_dlfo_process_initial,170,170,0,0.000,206,36,21.176,206,36,21.176
_dlfo_sort_mappings,80,80,0,0.000,128,48,60.000,128,48,60.000
_init_first,19,0,-19,-100.000,19,0,0.000,19,0,0.000
_int_free,8458,8458,0,0.000,102,-8356,-98.794,0,-8458,-100.000
_int_malloc,14516,14512,-4,-0.028,419,-14097,-97.114,416,-14100,-97.134
_itoa_word,3914,3928,14,0.358,52528,48614,1242.054,324528,320614,8191.467
access,9,0,-9,-100.000,9,0,0.000,9,0,0.000
bcmp,61,41,-20,-32.787,61,0,0.000,61,0,0.000
brk,26,0,-26,-100.000,26,0,0.000,18,-8,-30.769
bubble_sort,1126749,18006999,16880250,1498.138,0,-1126749,-100.000,0,-1126749,-100.000
call_init.part.0,142,142,0,0.000,195,53,37.324,195,53,37.324
check_match,5068,5068,0,0.000,5558,490,9.669,5558,490,9.669
check_stdfiles_vtables,12,0,-12,-100.000,12,0,0.000,12,0,0.000
compute_statistics,0,0,0,0.000,11023,11023,100.000,55023,55023,100.000
cos,0,0,0,0.000,7,7,100.000,0,0,0.000
cosf,0,0,0,0.000,7,7,100.000,0,0,0.000
dfs_traversal.part.0,284,284,0,0.000,385,101,35.563,385,101,35.563
dl_main,1738,1716,-22,-1.266,1798,60,3.452,1776,38,2.186
do_lookup_x,25431,25431,0,0.000,32970,7539,29.645,32970,7539,29.645
exit,8,0,-8,-100.000,8,0,0.000,0,-8,-100.000
exp2f@@GLIBC_2.27,0,0,0,0.000,7,7,100.000,0,0,0.000
expand_dynamic_string_token,46,46,0,0.000,46,0,0.000,46,0,0.000
expf@@GLIBC_2.27,0,0,0,0.000,7,7,100.000,0,0,0.000
fillin_rpath.isra.0,161,156,-5,-3.106,161,0,0.000,156,-5,-3.106
fma,0,0,0,0.000,6,6,100.000,0,0,0.000
free,2525,2525,0,0.000,22,-2503,-99.129,31,-2494,-98.772
fstat,28,0,-28,-100.000,35,7,25.000,35,7,25.000
fstatat,130,130,0,0.000,138,8,6.154,138,8,6.154
get_common_cache_info.constprop.0,215,215,0,0.000,215,0,0.000,215,0,0.000
get_common_indices.constprop.0,71,60,-11,-15.493,71,0,0.000,71,0,0.000
getrandom,9,0,-9,-100.000,9,0,0.000,0,-9,-100.000
getrlimit,10,0,-10,-100.000,10,0,0.000,10,0,0.000
hack_digit,0,0,0,0.000,724,724,100.000,710,710,100.000
handle_intel.constprop.0,596,596,0,0.000,596,0,0.000,596,0,0.000
handle_preload_list,71,71,0,0.000,71,0,0.000,71,0,0.000
index,427,408,-19,-4.450,547,120,28.103,547,120,28.103
init_cpu_features.constprop.0,384,378,-6,-1.562,384,0,0.000,378,-6,-1.562
init_tls,74,74,0,0.000,79,5,6.757,79,5,6.757
intel_check_word.constprop.0,5307,5307,0,0.000,5307,0,0.000,5307,0,0.000
isatty,15,0,-15,-100.000,15,0,0.000,15,0,0.000
log2f@@GLIBC_2.27,0,0,0,0.000,7,7,100.000,0,0,0.000
logf@@GLIBC_2.27,0,0,0,0.000,7,7,100.000,0,0,0.000
lookup_malloc_symbol,160,140,-20,-12.500,160,0,0.000,160,0,0.000
main,6042,24027,17985,297.666,19069,13027,215.607,95063,89021,1473.370
malloc,4691,4691,0,0.000,91,-4600,-98.060,86,-4605,-98.167
map_doit,15,0,-15,-100.000,15,0,0.000,15,0,0.000
memchr,21,0,-21,-100.000,21,0,0.000,21,0,0.000
memcpy,203,203,0,0.000,282,79,38.916,282,79,38.916
memcpy@@GLIBC_2.14,21,0,-21,-100.000,21,0,0.000,21,0,0.000
memmove,42,42,0,0.000,42,0,0.000,42,0,0.000
mempcpy,465,444,-21,-4.516,517,52,11.183,517,52,11.183
memrchr,19,0,-19,-100.000,19,0,0.000,19,0,0.000
memset,357,334,-23,-6.443,371,14,3.922,371,14,3.922
mmap,108,108,0,0.000,144,36,33.333,153,45,41.667
mprotect,30,30,0,0.000,36,6,20.000,36,6,20.000
munmap,6,0,-6,-100.000,6,0,0.000,12,6,100.000
munmap_chunk,0,0,0,0.000,0,0,0.000,29,29,100.000
open_path,681,681,0,0.000,876,195,28.634,876,195,28.634
open_verify.constprop.0,663,663,0,0.000,940,277,41.780,936,273,41.176
open_verify.constprop.1,251,251,0,0.000,251,0,0.000,251,0,0.000
openaux,36,36,0,0.000,90,54,150.000,90,54,150.000
partition,0,0,0,0.000,194395,194395,100.000,1152230,1152230,100.000
powf@@GLIBC_2.27,0,0,0,0.000,8,8,100.000,0,0,0.000
pthread_mutex_lock@@GLIBC_2.2.5,43,43,0,0.000,43,0,0.000,43,0,0.000
pthread_mutex_unlock@@GLIBC_2.2.5,34,34,0,0.000,34,0,0.000,34,0,0.000
ptmalloc_init.part.0,845,845,0,0.000,845,0,0.000,845,0,0.000
quicksort,0,0,0,0.000,9186,9186,100.000,42245,42245,100.000
quicksort'2,0,0,0,0.000,1955,1955,100.000,14478,14478,100.000
rand,0,0,0,0.000,5000,5000,100.000,25000,25000,100.000
random,0,0,0,0.000,21000,21000,100.000,105000,105000,100.000
random_r,0,0,0,0.000,31872,31872,100.000,159356,159356,100.000
rawmemchr,21,0,-21,-100.000,21,0,0.000,21,0,0.000
rindex,19,0,-19,-100.000,19,0,0.000,19,0,0.000
rtld_mutex_dummy,24,0,-24,-100.000,30,6,25.000,30,6,25.000
sbrk,64,49,-15,-23.438,64,0,0.000,64,0,0.000
sin,0,0,0,0.000,7,7,100.000,0,0,0.000
sincosf,0,0,0,0.000,7,7,100.000,0,0,0.000
sinf,0,0,0,0.000,7,7,100.000,0,0,0.000
stat,60,60,0,0.000,60,0,0.000,60,0,0.000
stpcpy,15,0,-15,-100.000,15,0,0.000,15,0,0.000
stpncpy,15,0,-15,-100.000,15,0,0.000,15,0,0.000
strcasecmp,5,0,-5,-100.000,5,0,0.000,0,-5,-100.000
strcasecmp_l,5,0,-5,-100.000,5,0,0.000,0,-5,-100.000
strcat,15,0,-15,-100.000,15,0,0.000,15,0,0.000
strchrnul,19,0,-19,-100.000,19,0,0.000,19,0,0.000
strcmp,5799,5782,-17,-0.293,8116,2317,39.955,8116,2317,39.955
strcpy,15,0,-15,-100.000,15,0,0.000,15,0,0.000
strcspn,238,233,-5,-2.101,238,0,0.000,233,-5,-2.101
strdup,54,48,-6,-11.111,72,18,33.333,64,10,18.519
string_processing,32345,32345,0,0.000,0,-32345,-100.000,0,-32345,-100.000
strlen,418,418,0,0.000,538,120,28.708,538,120,28.708
strncasecmp,5,0,-5,-100.000,5,0,0.000,0,-5,-100.000
strncasecmp_l,5,0,-5,-100.000,5,0,0.000,0,-5,-100.000
strncmp,17,0,-17,-100.000,17,0,0.000,17,0,0.000
strncpy,15,0,-15,-100.000,15,0,0.000,15,0,0.000
strnlen,38,38,0,0.000,42,4,10.526,38,0,0.000
strpbrk,5,0,-5,-100.000,5,0,0.000,0,-5,-100.000
strsep,248,248,0,0.000,248,0,0.000,248,0,0.000
strspn,5,0,-5,-100.000,5,0,0.000,0,-5,-100.000
strtol,5,0,-5,-100.000,5,0,0.000,0,-5,-100.000
sysmalloc,153,153,0,0.000,153,0,0.000,193,40,26.144
sysmalloc_mmap.constprop.0,0,0,0,0.000,0,0,0.000,54,54,100.000
tcache_init.part.0,117,117,0,0.000,117,0,0.000,117,0,0.000
tcgetattr,23,0,-23,-100.000,23,0,0.000,23,0,0.000
uname,6,0,-6,-100.000,6,0,0.000,0,-6,-100.000
update_active.constprop.0,194,194,0,0.000,194,0,0.000,194,0,0.000
version_check_doit,11,0,-11,-100.000,11,0,0.000,11,0,0.000
wcschr,38,38,0,0.000,42,4,10.526,38,0,0.000
wcscmp,19,0,-19,-100.000,19,0,0.000,19,0,0.000
wcscpy,7,0,-7,-100.000,7,0,0.000,0,-7,-100.000
wcslen,17,0,-17,-100.000,17,0,0.000,17,0,0.000
wcsnlen,17,0,-17,-100.000,17,0,0.000,17,0,0.000
wmemchr,42,42,0,0.000,46,4,9.524,42,0,0.000
wmemcmp,20,0,-20,-100.000,20,0,0.000,20,0,0.000
wmemset,34,34,0,0.000,38,4,11.765,34,0,0.000
write,9,0,-9,-100.000,9,0,0.000,9,0,0.000
